1 1 1 1 1 1 1 1 1 1 1 1 1 1 1 1 1 1 1 1 1 1 1 1 1 1 1 1 1 1
1 0 0 0 0 0 0 0 0 6 7 7 7 7 7 7 7 7 7 7 6 0 0 0 0 0 0 0 0 1
1 0 0 0 6 6 6 6 6 7 7 7 7 7 7 7 7 7 7 7 7 6 6 6 6 6 0 0 0 1
1 0 0 6 6 6 6 6 7 7 7 7 7 7 7 7 7 7 7 7 7 7 6 6 6 6 6 0 0 1
1 0 6 6 6 6 6 7 7 7 7 7 7 7 7 7 7 7 7 7 7 7 7 6 6 6 6 6 0 1
1 0 6 6 6 6 7 7 7 0 0 0 7 7 7 7 7 7 0 0 0 7 7 7 6 6 6 6 0 1
1 0 6 6 6 7 7 7 7 0 0 0 7 7 7 7 7 7 0 0 0 7 7 7 7 6 6 6 0 1
1 0 6 6 7 7 7 7 7 0 0 0 7 7 7 7 7 7 0 0 0 7 7 7 7 7 6 6 0 1
1 4 6 7 7 7 7 7 7 7 7 7 7 7 7 7 7 7 7 7 7 7 7 7 7 7 7 6 5 1
1 2 6 7 7 7 7 7 7 7 7 7 7 7 7 7 7 7 7 7 7 7 7 7 7 7 7 6 3 1
1 0 6 6 7 7 7 7 7 0 0 0 7 7 7 7 7 7 0 0 0 7 7 7 7 7 6 6 0 1
1 0 6 6 6 7 7 7 7 0 0 0 7 7 7 7 7 7 0 0 0 7 7 7 7 6 6 6 0 1
1 0 6 6 6 6 7 7 7 0 0 0 7 7 7 7 7 7 0 0 0 7 7 7 6 6 6 6 0 1
1 0 6 6 6 6 6 7 7 7 7 7 7 7 7 7 7 7 7 7 7 7 7 6 6 6 6 6 0 1
1 0 0 6 6 6 6 6 7 7 7 7 7 7 7 7 7 7 7 7 7 7 6 6 6 6 6 0 0 1
1 0 0 0 6 6 6 6 6 7 7 7 7 7 7 7 7 7 7 7 7 6 6 6 6 6 0 0 0 1
1 0 0 0 0 0 0 0 0 6 7 7 7 7 7 7 7 7 7 7 6 0 0 0 0 0 0 0 0 1
1 1 1 1 1 1 1 1 1 1 1 1 1 1 1 1 1 1 1 1 1 1 1 1 1 1 1 1 1 1
