1 1 1 1 1 1 1 1 1 1 1 1 1 1 1 1 1 1 1 1 1 1 1 1 1 1 1 1 1 1
1 1 1 1 1 1 1 1 1 0 0 0 0 3 0 0 4 0 0 0 0 1 1 1 1 1 1 1 1 1
1 1 1 1 1 1 1 1 0 0 1 0 1 0 1 1 0 1 0 1 0 0 1 1 1 1 1 1 1 1
1 1 1 1 1 1 1 0 0 1 1 0 1 0 1 1 0 1 0 1 1 0 0 1 1 1 1 1 1 1
1 1 1 1 1 1 0 0 6 1 1 0 1 0 7 7 0 1 0 1 1 6 0 0 1 1 1 1 1 1
1 1 1 1 1 0 0 1 6 1 1 0 1 6 1 1 6 1 0 1 1 6 1 0 0 1 1 1 1 1
1 1 1 1 0 0 1 1 6 1 1 6 1 0 7 7 0 1 6 1 1 6 1 1 0 0 1 1 1 1
1 1 7 0 0 7 0 0 0 1 1 6 1 7 1 1 7 1 6 1 1 0 0 0 7 0 0 7 1 1
1 1 7 0 1 1 1 1 0 1 1 7 1 7 6 6 7 1 7 1 1 0 1 1 1 1 0 7 1 1
1 1 7 0 1 1 1 1 0 1 1 7 1 7 6 6 7 1 7 1 1 0 1 1 1 1 0 7 1 1
1 1 1 0 0 1 1 1 6 1 1 0 1 7 1 1 7 1 0 1 1 6 1 1 1 0 0 1 1 1
1 1 1 1 0 0 1 1 6 1 1 0 1 0 7 7 0 1 0 1 1 6 1 1 0 0 1 1 1 1
1 1 1 1 1 0 0 1 6 1 1 0 1 6 1 1 6 1 0 1 1 6 1 0 0 1 1 1 1 1
1 1 1 1 1 1 0 0 6 1 1 0 1 0 7 7 0 1 0 1 1 6 0 0 1 1 1 1 1 1
1 1 1 1 1 1 1 0 0 1 1 0 1 0 1 1 0 1 0 1 1 0 0 1 1 1 1 1 1 1
1 1 1 1 1 1 1 1 0 0 1 0 1 0 1 1 0 1 0 1 0 0 1 1 1 1 1 1 1 1
1 1 1 1 1 1 1 1 1 0 0 0 0 2 0 0 5 0 0 0 0 1 1 1 1 1 1 1 1 1
1 1 1 1 1 1 1 1 1 1 1 1 1 1 1 1 1 1 1 1 1 1 1 1 1 1 1 1 1 1
