1 1 1 1 1 1 1 1 1 1 1 1 1 1 1 1 1 1 1 1 1 1 1 1 1 1 1 1 1 1
1 5 0 0 0 0 0 0 0 0 0 0 0 0 0 0 6 6 0 0 0 0 0 0 0 0 7 7 7 1
1 0 7 1 0 7 1 0 0 1 0 7 1 0 0 1 6 6 1 0 0 1 0 0 1 0 7 1 7 1
1 0 1 7 0 1 0 6 1 7 0 1 7 0 1 0 0 1 0 0 1 0 0 1 0 0 1 0 7 1
1 0 1 0 0 1 0 6 1 0 0 1 7 0 1 0 0 1 0 0 1 0 0 1 0 0 1 0 0 1
1 0 1 0 0 1 0 6 1 0 0 1 0 0 1 0 0 1 0 0 1 0 0 1 0 0 1 0 0 1
1 0 0 0 1 0 1 0 1 0 1 0 0 1 0 0 1 0 0 1 0 1 0 1 0 1 0 0 0 1
1 6 0 0 0 7 0 0 0 0 0 0 1 1 6 6 1 1 0 0 0 0 0 0 0 0 0 0 0 1
1 6 6 0 1 0 1 0 1 0 1 0 0 7 2 0 7 0 0 1 0 1 0 1 0 1 0 0 6 1
1 6 0 0 1 0 1 0 1 0 1 0 0 7 0 4 7 0 0 1 0 1 0 1 0 1 0 6 6 1
1 0 0 0 0 0 0 0 0 0 0 0 1 1 6 6 1 1 0 0 0 0 0 0 7 0 0 0 6 1
1 0 0 0 1 0 1 0 1 0 1 0 0 1 0 0 1 0 0 1 0 1 0 1 0 1 0 0 0 1
1 0 0 1 0 0 1 0 0 1 0 0 1 0 0 1 0 0 1 0 0 1 6 0 1 0 0 1 0 1
1 0 0 1 0 0 1 0 0 1 0 0 1 0 0 1 0 7 1 0 0 1 6 0 1 0 0 1 0 1
1 7 0 1 0 0 1 0 0 1 0 0 1 0 0 1 0 7 1 0 7 1 6 0 1 0 7 1 0 1
1 7 1 7 0 1 0 0 1 0 0 1 6 6 1 0 0 1 7 0 1 0 0 1 7 0 1 7 0 1
1 7 7 7 0 0 0 0 0 0 0 0 6 6 0 0 0 0 0 0 0 0 0 0 0 0 0 0 3 1
1 1 1 1 1 1 1 1 1 1 1 1 1 1 1 1 1 1 1 1 1 1 1 1 1 1 1 1 1 1
